1111111111111
10010000000C1
1000001111001
1P0011E100001
1111111111111